m-g-g-g-g-m-g-a-g-g-g-g-g-g-g-g-m-m-m-m-m-m-m-g-g-g-m-m-m-m-m-g-g-g-g-m-m-m-g-g-g-g
m-g-m-m-m-m-g-a-g-m-m-m-m-g-g-m-m-m-m-m-m-m-m-m-g-g-m-g-g-g-m-g-g-m-m-m-m-m-m-m-g-g
m-g-g-g-g-m-g-a-g-m-g-g-m-g-m-m-m-m-m-m-m-m-m-m-m-g-m-m-g-m-m-g-m-m-m-m-v-m-m-m-m-g
m-g-m-m-m-m-g-a-g-m-g-g-m-g-m-m-m-m-m-m-m-m-m-m-m-g-g-m-g-m-g-m-m-m-m-v-v-v-m-m-m-m
m-g-g-g-g-m-g-a-g-g-g-g-g-g-g-m-m-m-m-m-m-m-m-m-g-g-g-m-g-m-g-m-m-m-v-v-v-v-v-m-m-m
m-m-m-m-g-m-g-a-a-a-a-a-g-g-g-g-g-m-m-m-m-m-g-g-g-m-g-m-g-m-g-m-m-m-m-v-v-v-m-m-m-m
g-m-g-g-g-g-g-g-g-g-g-a-g-m-m-g-g-g-g-g-g-g-g-g-g-m-g-m-g-m-g-g-m-m-m-m-v-m-m-m-m-g
g-m-g-g-g-g-m-m-m-m-g-a-g-m-m-g-g-g-g-m-g-g-m-g-g-g-g-g-g-g-g-g-g-m-m-m-m-m-m-m-g-g
g-g-g-g-m-g-g-g-g-g-g-g-g-g-g-g-g-g-m-m-m-g-g-g-m-m-m-m-m-m-m-g-g-g-g-m-m-m-g-g-g-g
g-g-m-g-g-g-g-g-m-m-g-a-g-m-m-g-m-g-g-m-g-g-g-g-g-g-g-g-g-g-g-g-g-g-g-g-g-g-g-g-m-g
g-g-m-g-m-m-m-g-m-m-g-a-g-m-m-g-m-g-g-g-g-g-g-g-m-m-m-g-g-g-m-m-m-g-m-m-m-m-g-g-m-g
g-g-m-g-g-g-g-g-g-g-g-a-g-g-g-g-m-m-m-m-m-g-g-m-m-m-m-m-g-g-m-m-m-g-g-g-g-g-g-g-g-g
g-g-m-g-g-g-g-g-g-g-g-a-a-a-a-g-m-g-g-m-g-g-m-m-m-m-m-m-m-g-g-g-g-g-m-g-g-m-m-m-m-g
g-g-g-g-g-g-g-g-m-g-g-g-g-g-a-g-m-g-g-m-g-g-m-m-m-a-m-m-m-g-g-g-g-g-m-g-g-g-g-g-g-g
m-m-m-m-g-m-g-m-m-m-g-g-g-g-a-g-g-g-g-m-g-g-g-m-m-a-m-m-g-g-g-g-m-m-m-m-m-m-m-g-g-g
g-g-g-g-g-m-g-m-m-m-g-g-a-a-a-a-a-g-g-m-g-g-g-g-g-a-g-g-g-g-g-g-g-g-g-m-g-g-g-g-g-g
g-g-m-g-g-m-g-g-m-g-g-a-a-a-a-a-a-a-g-g-g-m-m-m-g-a-g-g-g-m-g-g-m-g-g-m-g-g-g-g-g-g
m-g-m-g-g-m-g-g-g-g-a-a-a-a-a-a-a-a-a-g-g-g-g-g-g-a-g-m-m-m-m-g-m-g-g-m-g-g-g-g-m-m
m-g-m-g-g-m-g-g-g-g-a-a-a-g-g-g-a-a-a-g-g-m-g-g-g-a-g-g-g-m-g-g-m-g-g-g-g-m-m-m-m-m
m-g-m-g-m-m-m-g-g-g-a-a-a-g-g-g-a-a-a-g-m-m-m-g-g-a-g-g-g-g-g-g-m-m-m-g-m-m-m-m-m-m
m-g-g-g-g-g-g-g-g-g-a-a-a-g-g-g-a-a-a-g-m-m-m-g-g-a-a-a-a-a-a-g-g-g-g-g-g-g-g-g-m-m
m-m-m-m-m-g-g-g-g-g-a-a-a-a-a-a-a-a-a-g-m-m-m-g-g-g-g-g-g-g-a-g-m-m-m-g-m-m-m-m-m-m
g-g-g-g-m-g-m-g-g-g-g-a-a-a-a-a-a-a-g-g-g-m-g-g-g-m-m-m-g-g-a-g-m-g-g-g-g-m-m-m-m-m
g-g-m-g-g-g-m-g-m-m-g-g-g-g-a-g-g-g-g-g-g-m-m-m-g-g-g-g-g-g-a-g-m-g-m-g-g-g-g-g-g-g
g-m-m-m-g-g-m-g-m-m-m-m-g-g-a-g-g-g-m-m-g-g-g-g-g-g-m-g-g-g-a-g-g-g-m-m-m-m-g-g-g-g
g-m-m-m-g-m-m-g-g-g-g-g-g-g-a-g-g-m-m-m-m-g-g-g-m-g-m-g-g-a-a-a-g-g-g-m-m-m-g-g-m-g
g-m-m-m-g-g-g-g-m-m-m-g-g-g-a-g-m-m-m-m-m-m-g-g-m-g-g-g-a-a-a-a-a-g-g-g-g-g-g-g-m-g
g-g-m-g-g-g-g-g-g-g-g-g-g-g-a-g-m-m-m-m-m-m-g-g-m-g-g-a-a-a-a-a-a-a-g-g-m-m-m-m-m-g
m-g-g-g-m-g-g-m-a-a-a-a-a-a-a-g-g-m-m-m-m-g-g-g-m-g-g-g-a-a-a-a-a-g-g-g-m-g-g-g-m-g
m-m-g-m-m-m-g-g-a-g-g-g-g-g-m-g-g-g-m-m-g-g-m-m-m-m-g-g-g-a-a-a-g-g-g-g-g-g-g-g-g-g
m-m-g-m-m-m-g-g-a-g-g-g-g-g-m-g-m-g-g-g-g-g-g-g-g-g-g-g-g-g-g-g-g-m-m-m-m-g-m-m-m-g
m-g-g-g-m-g-g-g-a-g-m-m-m-m-m-g-m-m-m-m-g-m-m-m-m-m-m-g-g-g-g-m-g-g-g-m-g-g-g-m-g-g
g-g-g-g-m-g-m-g-g-g-g-g-a-a-a-a-a-g-g-g-g-g-g-g-g-m-m-m-g-g-a-g-m-g-m-m-g-g-g-g-m-m
g-g-m-g-g-g-m-g-m-m-g-g-g-g-a-g-g-g-g-g-g-m-m-m-g-g-g-g-g-g-a-g-m-g-m-g-g-g-g-g-g-g
g-m-m-m-g-g-m-g-m-m-m-m-g-g-a-g-g-g-m-m-g-g-g-g-g-g-m-g-g-g-a-g-g-g-m-m-m-m-g-g-g-g
g-m-m-m-g-m-m-g-g-g-g-g-g-g-a-g-g-m-m-m-m-g-g-g-m-g-m-g-g-a-a-a-g-g-g-m-m-m-g-g-m-g
g-m-m-m-g-g-g-g-m-m-m-g-g-g-a-g-m-m-m-m-m-m-g-g-m-g-g-g-a-a-a-a-a-g-g-g-g-g-g-g-m-g
g-g-m-g-g-g-g-g-g-g-g-g-g-g-a-g-m-m-m-m-m-m-g-g-m-g-g-a-a-a-a-a-a-a-g-g-m-m-m-m-m-g
m-g-g-g-m-g-g-m-a-a-a-a-a-a-a-g-g-m-m-m-m-g-g-g-m-g-g-g-a-a-a-a-a-g-g-g-m-g-g-g-m-g
m-m-g-m-m-m-g-g-a-g-g-g-g-g-m-g-g-g-m-m-g-g-m-m-m-m-g-g-g-a-a-a-g-g-g-g-g-g-g-g-g-g
m-m-g-m-m-m-g-g-a-g-g-g-g-g-m-g-m-g-g-g-g-g-g-g-g-g-g-g-g-g-g-g-g-m-m-m-m-g-m-m-m-g
m-g-g-g-m-g-g-g-a-g-m-m-m-m-m-g-m-m-m-m-g-m-m-m-m-m-m-g-g-g-g-m-g-g-g-m-g-g-g-m-g-g
g-g-g-g-g-g-g-g-g-g-g-g-g-g-g-g-g-g-g-g-g-g-g-g-g-g-m-g-g-m-m-m-m-m-g-m-g-m-g-m-g-m
g-m-g-m-m-m-m-g-a-g-m-m-m-g-m-m-m-m-m-m-m-m-m-m-g-m-m-g-g-g-g-g-g-g-g-g-g-g-g-m-g-m
g-m-g-g-g-g-m-g-a-g-g-m-g-g-m-g-g-g-g-g-g-g-g-m-g-m-g-g-m-m-m-m-c-m-m-m-m-g-g-m-g-m
g-m-m-m-g-g-m-g-a-g-g-m-g-g-m-g-m-m-m-m-m-m-g-m-g-g-g-m-m-m-v-v-c-v-v-m-m-m-g-g-g-m
g-m-g-g-g-g-m-g-a-g-g-g-g-g-m-g-m-g-g-g-g-m-g-m-g-g-m-m-v-v-v-v-c-v-v-v-v-m-m-g-g-m
m-m-g-m-m-m-m-g-a-a-a-a-g-g-m-g-g-g-g-g-g-m-g-m-g-g-m-m-v-v-v-v-c-v-v-v-v-m-m-g-g-g
m-g-g-g-g-g-m-g-g-g-g-a-g-g-m-m-m-m-m-m-m-m-g-m-g-m-m-v-v-v-v-v-c-v-v-v-v-v-m-m-g-g
m-g-m-m-m-g-m-g-g-g-g-a-g-g-g-g-g-g-g-g-g-g-g-g-g-m-m-v-v-v-v-v-c-v-v-v-v-v-m-m-g-g
m-g-g-g-g-g-m-g-g-g-g-a-g-g-m-m-m-m-m-m-m-m-m-m-g-m-m-v-v-v-v-v-v-v-v-v-v-v-m-m-g-g

