m-m-m-m-g-g-g-g-g-m-m-m-m-g-g-g-g-g-g-g-m-m-m-m-m-g-g-m-g-g-g-g-g-g-g-g-m-m-m-m-m-m
g-g-g-m-m-m-m-m-g-g-m-m-g-g-m-m-m-g-g-g-m-g-g-g-g-g-g-m-g-g-g-g-g-g-m-m-m-g-g-g-g-g
g-m-g-g-g-m-g-g-g-g-g-g-g-m-m-m-m-m-g-g-m-g-m-m-m-m-g-m-g-m-m-m-m-g-g-g-m-g-m-g-m-g
g-m-g-m-g-m-g-m-g-g-m-m-g-g-m-m-m-g-g-g-m-g-g-g-g-g-g-m-g-g-g-g-g-g-g-g-m-g-m-g-m-g
g-m-g-m-g-g-g-m-g-m-m-m-m-g-g-g-g-g-m-m-m-g-m-g-g-g-g-g-g-g-g-m-g-m-g-g-g-g-m-g-m-g
g-g-g-m-g-g-g-m-g-g-m-m-g-g-g-m-g-g-g-g-g-g-m-m-m-m-m-m-g-g-g-m-g-g-g-g-m-m-m-m-m-m
m-m-m-m-m-m-m-m-g-g-g-g-g-g-g-m-m-m-m-m-g-g-m-g-g-g-g-g-g-g-g-m-g-g-m-g-g-g-g-g-g-g
g-g-g-g-g-g-g-g-g-g-g-g-m-g-g-g-g-g-g-g-g-g-g-g-g-g-m-m-g-g-g-g-g-g-m-g-a-a-a-a-a-a
g-g-g-a-a-a-a-a-g-a-a-a-a-g-m-g-m-m-g-g-g-g-g-g-g-m-m-m-m-g-g-m-m-g-m-g-a-g-g-g-g-g
g-g-g-a-g-g-g-g-g-g-g-g-a-g-m-g-m-m-g-g-g-g-g-g-g-g-m-m-g-g-g-m-m-g-m-g-a-g-m-m-m-g
g-g-g-a-g-g-g-m-g-m-g-g-a-g-m-g-m-g-g-g-a-a-a-a-a-g-g-g-g-g-g-g-g-g-g-g-a-g-g-g-m-g
a-a-a-a-g-m-m-m-g-m-g-g-a-g-g-g-m-g-g-a-a-a-a-a-a-a-g-g-g-a-a-a-a-g-a-a-a-g-g-g-m-g
g-g-g-g-g-g-g-m-g-m-g-g-a-g-g-g-g-g-a-a-a-a-a-a-a-a-a-g-g-a-g-g-g-g-g-g-g-g-m-m-m-g
g-g-g-g-g-g-g-g-g-m-g-g-a-g-g-g-g-g-a-a-a-g-g-g-a-a-a-g-g-a-g-m-m-g-m-m-g-g-g-g-g-g
m-g-m-m-m-m-m-m-g-m-m-m-a-a-a-a-a-a-a-a-a-g-g-g-a-a-a-a-a-a-g-m-m-g-m-m-g-g-m-m-g-g
m-g-m-g-g-g-g-m-g-g-g-g-g-g-g-g-g-g-a-a-a-g-g-g-a-a-a-g-g-g-g-g-g-g-g-g-g-m-m-m-m-g
m-g-m-g-m-m-g-m-g-m-m-g-g-m-m-g-g-g-a-a-a-a-a-a-a-a-a-g-m-m-m-m-m-g-g-g-g-m-m-m-m-m
m-g-m-g-g-m-g-m-g-m-g-g-m-m-m-m-g-g-g-a-a-a-a-a-a-a-g-g-g-g-m-g-g-g-g-g-m-m-m-m-m-m
m-g-m-g-g-m-g-m-g-m-g-m-m-m-m-m-m-g-g-g-a-a-a-a-a-g-g-g-g-g-m-g-g-m-g-g-m-m-m-m-m-m
m-g-m-g-g-m-g-m-g-m-g-m-m-m-m-m-m-g-g-g-g-g-g-g-g-g-m-m-m-m-m-g-m-m-m-g-m-m-m-m-m-m
m-g-m-g-g-m-g-m-g-g-g-g-m-m-m-m-g-g-g-g-m-m-m-g-g-g-g-g-g-g-m-g-g-m-g-g-m-m-m-m-m-m
m-g-m-m-m-m-g-m-g-m-g-g-g-m-m-g-g-m-g-m-m-m-m-m-g-m-g-g-g-g-g-g-g-g-g-g-m-m-m-m-m-m
m-g-g-g-g-g-g-m-g-m-g-m-g-g-g-g-g-m-g-g-m-m-m-g-g-m-g-g-m-m-g-g-g-g-m-g-g-m-m-m-m-m
m-g-m-m-m-m-m-m-g-m-g-m-g-g-g-g-g-m-g-g-g-g-g-g-g-m-g-m-m-m-m-g-g-g-g-g-g-m-m-m-m-g
g-g-g-g-g-g-g-g-g-m-g-m-m-m-m-m-g-g-g-g-g-g-g-g-g-g-g-m-m-m-m-m-g-m-g-g-g-g-m-m-g-g
m-m-m-g-g-g-m-m-g-m-g-m-g-g-g-g-g-g-m-m-g-a-a-a-a-a-a-a-a-m-m-m-g-m-g-m-m-g-g-g-g-g
m-m-m-m-m-g-g-m-m-m-g-g-g-g-g-m-m-g-m-m-g-a-g-g-g-g-g-m-m-m-m-m-g-m-g-g-g-g-g-m-m-m
v-v-v-m-m-m-g-g-g-g-g-g-g-a-g-g-g-g-m-m-g-a-g-g-m-g-g-m-m-m-m-g-g-m-g-m-m-m-m-m-g-m
v-v-v-v-v-m-m-g-g-g-g-g-a-a-a-g-g-g-g-g-g-a-g-g-m-g-g-g-m-m-g-g-g-m-g-g-g-g-g-g-g-m
v-v-v-v-v-m-m-g-m-g-g-a-a-a-a-a-g-g-g-g-g-a-g-m-m-m-g-g-g-g-g-g-g-m-g-m-m-m-m-m-g-m
v-v-v-v-v-v-m-g-m-g-g-a-a-a-a-a-a-a-a-a-a-a-g-g-m-g-g-g-g-g-m-m-g-m-g-g-g-g-g-m-m-m
v-v-v-v-v-v-m-g-m-m-g-a-a-a-a-a-g-g-g-g-g-g-g-g-g-g-g-g-g-g-m-m-g-g-g-g-m-m-m-g-g-g
v-c-c-c-c-c-c-g-m-g-g-g-a-a-a-g-g-m-m-m-m-g-m-m-m-m-g-m-g-g-m-m-g-g-g-m-m-m-m-m-g-g
v-v-v-v-v-v-m-g-m-g-m-g-g-a-g-g-g-g-g-g-m-g-m-g-g-g-g-m-g-g-g-g-g-g-m-m-m-m-m-m-m-g
v-v-v-v-v-v-m-g-g-g-m-g-g-g-g-g-m-m-m-g-m-g-m-g-g-g-g-m-m-m-g-m-g-g-m-m-m-v-m-m-m-g
v-v-v-v-v-m-m-g-m-m-m-g-g-g-g-m-m-g-m-g-g-g-g-g-m-m-m-m-g-g-g-m-g-m-m-m-v-v-v-m-m-m
v-v-v-v-v-m-m-g-g-g-m-g-m-m-g-m-m-g-g-g-m-g-m-g-g-g-g-m-g-g-g-m-g-m-m-v-v-v-v-v-m-m
v-v-v-m-m-m-g-g-m-g-g-g-g-m-g-m-m-g-g-m-m-g-m-m-g-g-g-m-g-m-g-m-g-m-m-m-v-v-v-m-m-m
m-m-m-m-m-g-g-g-g-g-m-g-g-m-g-g-g-g-g-m-m-g-m-m-g-g-g-m-g-m-g-g-g-g-m-m-m-v-m-m-m-g
m-m-m-g-g-g-m-m-m-m-m-g-g-m-g-g-g-g-g-m-m-g-m-m-g-g-g-g-g-m-g-g-g-g-m-m-m-m-m-m-m-g
g-g-g-g-g-g-g-g-g-g-m-g-m-m-m-m-g-g-m-m-m-m-m-m-m-g-g-g-g-m-g-m-m-g-g-m-m-m-m-m-g-g
g-g-g-g-m-m-m-m-m-g-g-g-g-g-g-g-g-g-m-m-m-m-m-m-m-g-g-g-g-g-g-g-g-g-g-g-m-m-m-g-g-g

